10101111111
90001011001
10101000011
10000011001
11111111101
00001110001
01100000111
08001101001
01101000011