11111
10101
00001
10101
11101
11101
10001
10111
10001
10111
10009
11111